00000000
00000000
00100100
00111100
00111100
00111100
00011000
00000000

