00000000000000000000
00000000000000000000
00000000000000000000
00000000000000000000
00000000000000000000
00000000000000000000
00000000000000000000
00000000000000000000
00009999999999990000
00009000000000090000
00009000000000090000
00009000000000090000
00009000000000090000
00009000000000090000
00009000000000090000
00009000000000090000
00009000000000090000
00009000000000090000
00009000000000090000
00009000000000090000
00009000000000090000
00009000000000090000
00009000000000090000
00009000000000090000
00009000000000090000
00009000000000090000
00009999999999990000
00000000000000000000
00000000000000000000
00000000000000000000
00000000000000000000
00000000000000000000
00000000000000000000
00000000000000000000
00000000000000000000