00000000000000000000000000000000000000000000000000000000000
00000000000001000000000000000000000000000000000000000001000
00000000000000000000000000000000000000000000000000000000000
00000000000000000000000000000000000000000000000000000000000
00000000000000000000000000000000000000000000000000000000000
00000000000000000000000000000000000000000000000000000000000
00000000000000000000000000000000000000000000000000000000000
00000000000000000000000000000000000000000000000000000000000
00000099999999999999999999999999999999999999999999999000000
00000090000000000000000000000000000000000000000000009000000
00000090100000000140000000000000000000000000000010009000000
00000090000030000000000000000000000000007000000000009000000
00000090000000000200000000000000000000000000200000009000000
00000090100000000000000000000000000000002000000000009000000
00000090000000000000000000003000000000000000000000009000000
00000090000000000300001000000000000000000000000000009000000
00000090400000400000000000000000004000000000000000009000000
00000090000000000300000000000000000000001000000080009000000
00000090000000000000000000000000000000000000000000009000000
00000090030000000000000000000000000000000000000004009000000
00000090000000000200000000010000000000010008000000009000000
00000090000400000000000000000000000000000000000000009000000
00000090000000000000000000000000002000000000000800009000000
00000090000001000000000000000000000000000000000000009000000
00000090000000000000000000000000000000000000000000009000000
00000090000000000000000000000000000000000000000000009000000
00000090000000000000000000000000000300000000000000009000000
00000090000000000000000000000000000000000000000000009000000
00000090000004000000000000000000000000000000000005009000000
00000090000000000080000000000000000000000000000000009000000
00000090002000000000000000000000000000000000000000009000000
00000090000000000000000000000000000000000000007770009000000
00000090300000000000000000000000000000000000000000009000000
00000090000000000000000000000000000000000000010000009000000
00000090000000000000000000000000000000000000000000009000000
00000090000000200000000000000000000000000000000002009000000
00000099999999999999999999999999999999999999999999999000000
00000000000000000000000000000000000000000000000000000000000
00000000000000000000000000000000000000000000000000000000000
00000000000000000000000000000000000000000000000000000000000
00000000000000000000000000000000000000000000000000000000000
00000000000000000000000000000000000000000000000000000000000
00000000000000000000000000000000000000000000000000000000000
00000000000000000000000000000000000000000000000000000000000
00000000000000000000000000000000000000000000000000000000000